|------|-------|-------|
| test | test2 | test3 |
|------|-------|-------|
| x    | y     | x     |
|      | y     | x     |
| x    |       | x     |
|------|-------|-------|
